Your family has been in Skunk Hollow for many generations. Long enough to know the folklore of the area, and long enough to not talk about it.

You had heard rumours of lost treasures hidden somewhere deep in the forest, but no one knows where, or even why, they would be there. You had always chalked that up to local myth.

Yesterday, you decided to spend some time at the library. While you were browsing through books in the 929 category, you spotted a thin, unlabeled pamphlet. Taking a look at it, you found it to be a tedious genealogy of some family you had never heard of. A bit of a close glance revealed that this little book is far weirder. Vague allusions to monsters and demons, inexplicable handwritten notes in the margins and implications of murder and infidelity hide amongst the pages. Near the back was a faded, yellow sheet of paper with a crudely drawn map indicating a house in the forests north of town. The map had numerous notes written all over it - most of them unintelligable. A few phrases like "...was hidden below the cellar" and "" "... must never know" made this  map intriguing. Something worth investigating.

So, now you find yourself with a photocopy of the map (the original is tucked back inside the book) parked at the end of a little used road in a dark forest.
!!!! The wumpus is in unstable room
!!! very bloody Narrow Passage
!!!! bloody Small room
!!!! bloody Interesting Room
!!!! bloody unstable room
!!!! bloody Dead Letter Office
!!! very bloody turnip room
!!!!
unstable room is already bloody

Dungeon Crawl Game
An Interactive Fiction by autowitch
Release 1 / Serial number 130927 / Inform 7 build 6G60 (I6/v6.32 lib 6/12N) SD

Side of the Road
You at the end of a little used dirt road. A dense, dark forest surrounds you. A narrow rocky trail leads to the north. It may have been a driveway at one time, but is too overgrown to tell for sure. To road leads back to Skunk Hollow to the southeast.

You can see your 1974 Ford Pinto (empty) here.

foo

>n
Dense Forestfoo
You are in a dense forest. Only occasionally can the sky be seen through the canopy. A faint trail runs north to south here.

>n
Denser Forest
The silent forest completely overwhelms everything. It is almost completely dark. The trail heads south back to your car or east deeper into the forest.

You can see a pile of leaves here.

>n
You can't go that way.

* * *

>n
Denser Forest
The silent forest completely overwhelms everything. It is almost completely dark. The trail heads south back to your car or east deeper into the forest.

You can see a pile of leaves here.

>count leaves
There are 69,105 leaves here.

>take leaves
Taken.

>count leaves
There are 69,105 leaves here.

>s
Dense Forest
You are in a dense forest. Only occasionally can the sky be seen through the canopy. A faint trail runs north to south here.

>count trees
You can't see any such thing.

>n
Denser Forest
The forest completely overwhelms

>n
You can't go that way.

[From here, you can go south and east.]

>e
Even Still Denser Forest
The forest is incredibly dense here. All is dark and still.

>se
House Ruins
You are in a small clearing next to the ruins of a long collapsed house. Large boards, bits of white painted siding and the foundation are all that remain.

You can see a beat up old mailbox (empty) here.

* * *

>n
Denser Forest
The silent forest completely overwhelms everything. It is almost completely dark. The trail heads south back to your car or east deeper into the forest.

You can see a pile of leaves here.

>take leaves
Taken.

>count them
[I'm not sure what "them" refers to.]

>count it
There are 69,105 leaves here.

>n
You can't go that way.

[From here, you can go south and east.]

* * *

>se
House Ruins
You are in a small clearing next to the ruins of a long collapsed house. Large boards, bits of white painted siding and the foundation are all that remain.

You can see a beat up old mailbox (empty) here.

>count mailbox
One. One beat up old mailbox.

>count house
You can't see any such thing.

* * *

>count leaves
There are 69,105 leaves here.

>e
Even Still Denser Forest
The forest is incredibly dense here. All is dark and still.

* * *

>se
House Ruins
You are in a small clearing next to the ruins of a long collapsed house. Large boards, bits of white painted siding and the foundation are all that remain.

You can see a beat up old mailbox (empty) here.

>take mailbox
(putting the flashlight into the backpack to make room)
Taken.

>i
You are carrying:
  a beat up old mailbox
  a pile of leaves
  a map
  a backpack (being worn and open)
    a flashlight

>n
You can't go that way.

[From here, you can go northwest and south.]

>s
Amidst the Ruins
You are just inside of the ruins. It looks like most of the house has fallen into its own cellar.

>search rubble
You paw around in the mounds of debris and uncover an unexpectedly undamaged brass lantern

>x rubble
Piles of fallen timbers and rubble fill the cellar

>take lantern
(putting the map into the backpack to make room)
[That's already open.]

Taken.

>eat it
[You can't consume the brass lantern, or that's not the way to do so.]

>LOOK
Amidst the Ruins
You are just inside of the ruins. It looks like most of the house has fallen into its own cellar.

>put lantern in mailbox
The brass lantern is too big to fit in the mailbox

>LOOK
Amidst the Ruins
You are just inside of the ruins. It looks like most of the house has fallen into its own cellar.

>i
You are carrying:
  a brass lantern
  a beat up old mailbox
  a pile of leaves
  a backpack (being worn and open)
    a map
    a flashlight

>put leaves in mailbox
You put the pile of leaves into the beat up old mailbox.

>i
You are carrying:
  a brass lantern
  a beat up old mailbox
    a pile of leaves
  a backpack (being worn and open)
    a map
    a flashlight

>put map in backpac
>PUT MAP IN BACKPACK
[That's already open.]

(first taking the map)

You put the map into the backpack.

>i
You are carrying:
  a brass lantern
  a beat up old mailbox
    a pile of leaves
  a backpack (being worn and open)
    a map
    a flashlight

You feel a slight twitch from the mailbox.

>put map in mailbox
(first taking the map)

You put the map into the beat up old mailbox.

>l
Amidst the Ruins
You are just inside of the ruins. It looks like most of the house has fallen into its own cellar.

>i
You are carrying:
  a brass lantern
  a beat up old mailbox
    a map
  a backpack (being worn and open)
    a flashlight

* * *

>take leaves
Taken.

>e
Even Still Denser Forest
The forest is incredibly dense here. All is dark and still.

>count leaves
There are 69,105 leaves here.

>se
House Ruins
You are in a small clearing next to the ruins of a long collapsed house. Large boards, bits of white painted siding and the foundation are all that remain.

You can see a beat up old mailbox (empty) here.

>n
You can't go that way.

[From here, you can go northwest and south.]

* * *

>s
Amidst the Ruins
You are just inside of the ruins. It looks like most of the house has fallen into its own cellar.

>search ruins
Amidst the Ruins
You are just inside of the ruins. It looks like most of the house has fallen into its own cellar.

>search rubble
You paw around in the mounds of debris and uncover an unexpectedly undamaged brass lantern

>g
You paw around some more in the ruins. Underneath a large timber, you see a debris filled stairway going down. Unfortunately, it is completely blocked.

>x stairway
The very top steps of a debris blocked stairway leading down.

>search rubbl3
>SEARCH RUBBLE
[Which do you mean, 1) Rubble filled stairway or 2) Rubble?]

>2
You dig around in the debris some more and find a pornographic magazine for gnomes

>l
Amidst the Ruins
You are just inside of the ruins. It looks like most of the house has fallen into its own cellar.

You can see Gnome porn and a brass lantern here.

>take all
Gnome porn: (putting the flashlight into the backpack to make room)
Taken.
brass lantern: (putting the map into the backpack to make room)
Taken.

>i
You are carrying:
  a brass lantern
  Gnome porn
  a pile of leaves
  a backpack (being worn and open)
    a map
    a flashlight

>turn on lantern
You turn on the brass lantern.

>LOOK
Amidst the Ruins
You are just inside of the ruins. It looks like most of the house has fallen into its own cellar.

>read porn
You see nothing unexpected about Gnome porn.

* * *

>n
Denser Forest
The silent forest completely overwhelms everything. It is almost completely dark. The trail heads south back to your car or east deeper into the forest.

You can see a pile of leaves here.

>search leaves
You find that the pile of leaves only contains leaves.

>count it
There are 69,105 leaves here.

>ne
You can't go that way.

[From here, you can go south and east.]

>e
Even Still Denser Forest
The forest is incredibly dense here. All is dark and still.

* * *

>se
House Ruins
You are in a small clearing next to the ruins of a long collapsed house. Large boards, bits of white painted siding and the foundation are all that remain.

You can see a beat up old mailbox (empty) here.

>x mailbox
A dented and rusty mailbox. The door has been torn off.

>take it
Taken.

>eat it
[You can't consume the beat up old mailbox, or that's not the way to do so.]

>listen to mailbox
You shake the mailbox and hear nothing.

>LOOK
House Ruins
You are in a small clearing next to the ruins of a long collapsed house. Large boards, bits of white painted siding and the foundation are all that remain.

>n
You can't go that way.

[From here, you can go northwest and south.]

* * *

>s
Amidst the Ruins
You are just inside of the ruins. It looks like most of the house has fallen into its own cellar.

>x debris
Piles of fallen timbers and rubble fill the cellar

>search it
You paw around in the mounds of debris and uncover an unexpectedly undamaged brass lantern

>l
Amidst the Ruins
You are just inside of the ruins. It looks like most of the house has fallen into its own cellar.

You can see a brass lantern here.

>take lantern
(putting the flashlight into the backpack to make room)
[The backpack is closed.]

>i
You are carrying:
  a beat up old mailbox
  a map
  a flashlight
  a backpack (being worn and closed)

* * *

>n
Denser Forest
The silent forest completely overwhelms everything. It is almost completely dark. The trail heads south back to your car or east deeper into the forest.

You can see a pile of leaves here.

>e
Even Still Denser Forest
The forest is incredibly dense here. All is dark and still.

* * *

>se
House Ruins
You are in a small clearing next to the ruins of a long collapsed house. Large boards, bits of white painted siding and the foundation are all that remain.

You can see a beat up old mailbox (empty) here.

>s
Amidst the Ruins
You are just inside of the ruins. It looks like most of the house has fallen into its own cellar.

* * *

>search rubble
You paw around in the mounds of debris and uncover an unexpectedly undamaged brass lantern

>take lantern
Taken.

* * *

>i
You are carrying:
  a brass lantern (providing light)
  a map
  a flashlight
  a backpack (being worn and closed)

>LOOK
Amidst the Ruins
You are just inside of the ruins. It looks like most of the house has fallen into its own cellar.

>take mailbox
[You can't see the beat up old mailbox any more.]

>n
House Ruins
You are in a small clearing next to the ruins of a long collapsed house. Large boards, bits of white painted siding and the foundation are all that remain.

You can see a beat up old mailbox (empty) here.

>take mailbox
(putting the flashlight into the backpack to make room)
Taken.

>i
You are carrying:
  a beat up old mailbox
  a brass lantern (providing light)
  a map
  a backpack (being worn and open)
    a flashlight

>nw
Even Still Denser Forest
The forest is incredibly dense here. All is dark and still.

>w
Denser Forest
The forest completely overwhelms

You can see a pile of leaves here.

>take leaves
(putting the map into the backpack to make room)
Taken.

>i
You are carrying:
  a pile of leaves
  a beat up old mailbox
  a brass lantern (providing light)
  a backpack (being worn and open)
    a map
    a flashlight

* * *

>n
Denser Forest
The silent forest completely overwhelms everything. It is almost completely dark. The trail heads south back to your car or east deeper into the forest.

You can see a pile of leaves here.

>nw
You can't go that way.

[From here, you can go south and east.]

>move leaves
When you move the leaves, you notice some animal tracks going to the northwest.

>nw
Faint animal path
A faint animal path runs northwest to southeast.

* * *

>n
Denser Forest
The silent forest completely overwhelms everything. It is almost completely dark. The trail heads south back to your car or east deeper into the forest.

You can see a pile of leaves here.

>move leaves
When you move the leaves, you notice some animal tracks going to the northwest.

>search it
You find that the pile of leaves only contains leaves.

>nw
Faint animal path
A faint animal path runs northwest to southeast.

>nw
Clearing
A small clearing in the forest. The most notable aspect is a largish rabbit hole off to the side

>d
You can't go that way.

[The only way to go is southeast.]

>l
Clearing
A small clearing in the forest. The most notable aspect is a largish rabbit hole off to the side

>d
You can't go that way.

[The only way to go is southeast.]

>LOOK
Clearing
A small clearing in the forest. The most notable aspect is a largish rabbit hole off to the side

>u
You can't go that way.

[The only way to go is southeast.]

* * *

>nw
Clearing
A small clearing in the forest. The most notable aspect is a largish rabbit hole off to the side

>d
Darkness
It is pitch black. You are likely to be eaten by a grue.

>d
Darkness
It is pitch black. You are likely to be eaten by a grue.

>e
It is pitch dark, and you can't see a thing.

>u
Darkness
It is pitch black. You are likely to be eaten by a grue.

>u
BAR
Clearing
A small clearing in the forest. The most notable aspect is a largish rabbit hole off to the side

* * *

>d
Darkness
It is pitch black. You are likely to be eaten by a grue.

>u
Darkness
It is pitch black. You are likely to be eaten by a grue.

>u
Clearing
A small clearing in the forest. The most notable aspect is a largish rabbit hole off to the side

>d
Darkness
It is pitch black. You are likely to be eaten by a grue.

>LOOK
Darkness
It is pitch black. You are likely to be eaten by a grue.

>n
Oh no! You have walked into the slavering fangs of a lurking grue!

    *** You are tasty. ***

You scored 0 out of a possible 0, in 12 turns.

Would you like to RESTART, RESTORE a saved game, QUIT or UNDO the last command?

>undo
Darkness
[Previous turn undone.]

>u
Clearing
A small clearing in the forest. The most notable aspect is a largish rabbit hole off to the side

* * *

>d
Darkness
It is pitch black. You are likely to be eaten by a grue.

>u
Clearing
A small clearing in the forest. The most notable aspect is a largish rabbit hole off to the side

* * *

>d
Darkness
It is pitch black. You are likely to be eaten by a grue.

>u
Oh no! You have walked into the slavering fangs of a lurking grue!

    *** You are tasty. ***

You scored 0 out of a possible 0, in 19 turns.

Would you like to RESTART, RESTORE a saved game, QUIT or UNDO the last command?

* * *

>n
Dense Forestfoo
You are in a dense forest. Only occasionally can the sky be seen through the canopy. A faint trail runs north to south here.

>take car
[You can't see your 1974 Ford Pinto any more.]

>s
Side of the Road
You are on the shoulder of a little used dirt road.

You can see your 1974 Ford Pinto (empty) here.

>s
on foot

>take car
[Your 1974 Ford Pinto isn't portable.]

>enter car
You get into your 1974 Ford Pinto.

>s
in car

>exit
You get out of your 1974 Ford Pinto.

Side of the Road
You are on the shoulder of a little used dirt road.

You can see your 1974 Ford Pinto (empty) here.

>s
on foot

* * *

>n
Dense Forestfoo
You are in a dense forest. Only occasionally can the sky be seen through the canopy. A faint trail runs north to south here.

>e
You can't go that way.

[From here, you can go north and south.]

* * *

>i
You are carrying:
  a map
  a flashlight
  a backpack (being worn and closed)

>x map
A photocopy of a map that you found at the library. You were browsing in the local history section and found

>eat map
[You can't consume the map, or that's not the way to do so.]

* * *

>i
You are carrying:
  a map
  a flashlight
  a backpack (being worn and closed)

>x backpack
The backpack is empty.

* * *

>i
You are carrying:
  a map
  a flashlight
  a backpack (being worn and closed)

>open backpack
You open the backpack.

>x map
A photocopy of a map that you found at the library. You were browsing in the local history section and found

>turn on flashlight
You push the button on the flashlight. Nothing happens. You realized that you forgot to check the batteries before heading out. The flashlight is not going to be of much use today.

>g
You push the button on the flashlight. Nothing happens.

* * *

>eat map
You take a nibble out of the corner of the map. It tastes like paper and toner. Do you normally eat paper?

>lick map
[That's not a verb I recognise.]

* * *

>lick map
[I can't understand your entire command: the first part might be an action I know, but I didn't expect the word "map" next.]

>taste map
You lick the map. A bit becomes smudged and you have some toner on your tongue. Happy now?

>taste
(the map)
You lick the map. A bit becomes smudged and you have some toner on your tongue. Happy now?

>lick
[You must supply a noun.]

>lick map
[I can't understand your entire command: the first part might be an action I know, but I didn't expect the word "map" next.]

>smell map
You smell nothing unexpected.

>LOOK
Side of the Road
You are on the shoulder of a little used dirt road.

>read map
A photocopy of a map that you found at the library. You were browsing in the local history section and found

>g
A photocopy of a map that you found at the library.

* * *

>turn on flashlight
You push the button on the flashlight. Nothing happens.
 You realized that you forgot to check the batteries before heading out.

>turn off flashlight
That's already off.

>turn off flashlight
That's already off.

* * *

>x flashlight
Your trusty flashlight.

>turn it on
You push the button on the flashlight. Nothing happens. You realized that you forgot to check the batteries before heading out. The flashlight is not going to be of much use today. Oh well, at least you can still look around on the surface.

>i
You are carrying:
  a map
  a flashlight

* * *

>turn it on
You push the button on the flashlight. Nothing happens. You realized that you forgot to check the batteries before heading out. The flashlight is not going to be of much use today. Oh well, at least you can still look around on the surface.

>x it
Your trusty flashlight, until today.

* * *

>eat flashlight
[You can't consume the flashlight, or that's not the way to do so.]

>i
You are carrying:
  a map
  a flashlight
  a backpack (being worn and closed)

>turn on flashlight.
You push the button on the flashlight. Nothing happens. You realized that you forgot to check the batteries before heading out. The flashlight is not going to be of much use today. Oh well, at least you can still look around on the surface.

>x it
A plasticx

* * *

>x piece of shit
Your 1974 Ford Pinto is empty.

* * *

>s
on foot south

>se
on foot southeast

>enter
You get into your 1974 Ford Pinto.

>s
in car south

* * *

>se
Not being so sure that your trusty 1974 Pinto will make it the rest of the way into town, you decide to walk. You start hiking down the road

    *** You have died ***

You scored 0 out of a possible 0, in 1 turn.

Would you like to RESTART, RESTORE a saved game, QUIT or UNDO the last command?

>undo
Side of the Road
[Previous turn undone.]

>enter car
You get into your 1974 Ford Pinto.

>se
    *** You have won ***

You scored 0 out of a possible 0, in 2 turns.

Would you like to RESTART, RESTORE a saved game, QUIT or UNDO the last command?

>undo
Side of the Road
[Previous turn undone.]

>LOOK
Side of the Road (in your 1974 Ford Pinto)
You are on the shoulder of a little used dirt road.

* * *

>LOOK
Side of the Road
You at the end of a little used dirt road. A dense, dark forest surrounds you. A narrow rocky trail leads to the north. It may have been a driveway at one time, but is too overgrown to tell for sure. To road leads back to Skunk Hollow to the southeast.

You can see your 1974 Ford Pinto (empty) here.

foo

>se
Not being so sure that your trusty 1974 Pinto will make it back down this old road and back into town, you decide to walk. You start hiking down the road. A couple of weeks later there is a manhunt, but you are never found.

    *** You are never seen again. ***

You scored 0 out of a possible 0, in 2 turns.

Would you like to RESTART, RESTORE a saved game, QUIT or UNDO the last command?

>undo
Side of the Road
[Previous turn undone.]

* * *

>enter car
You get into your 1974 Ford Pinto.

>se
You back up to try to turn around, but back into a tree. Given that you are in a Pinto, this results in a massive fireball that could be seen for miles around and was talked about for years.

    *** You have become a crispy critter ***

You scored 0 out of a possible 0, in 3 turns.

Would you like to RESTART, RESTORE a saved game, QUIT or UNDO the last command?

>undo
Side of the Road
[Previous turn undone.]

>se
You look at the time. It took you longer to get here than you thought . It's probably not a bad idea to return home.

    *** Maybe some other day ***

You scored 0 out of a possible 0, in 3 turns.

Would you like to RESTART, RESTORE a saved game, QUIT or UNDO the last command?

>undo
Side of the Road
[Previous turn undone.]

>l
Side of the Road (in your 1974 Ford Pinto)
You at the end of a little used dirt road. A dense, dark forest surrounds you. A narrow rocky trail leads to the north. It may have been a driveway at one time, but is too overgrown to tell for sure. To road leads back to Skunk Hollow to the southeast.

>n
That's a narrow, rocky trail through a dense forest. Your Pinto is not the greatest off-road vehicle.

>exit
You get out of your 1974 Ford Pinto.

Side of the Road
You at the end of a little used dirt road. A dense, dark forest surrounds you. A narrow rocky trail leads to the north. It may have been a driveway at one time, but is too overgrown to tell for sure. To road leads back to Skunk Hollow to the southeast.

You can see your 1974 Ford Pinto (empty) here.

>s
on foot south

>n
Dense Forest
You are in a dense forest. Only occasionally can the sky be seen through the canopy. A faint trail runs north to south here.

* * *

>LOOK
Side of the Road
You at the end of a little used dirt road. A dense, dark forest surrounds you. A narrow rocky trail leads to the north. It may have been a driveway at one time, but is too overgrown to tell for sure. To road leads back to Skunk Hollow to the southeast.

You can see your 1974 Ford Pinto (empty) here.

foo

>search car
Some beer cans, fast food wrappers and other junk. Nothing that you want.

>n
Dense Forest
You are in a dense forest. Only occasionally can the sky be seen through the canopy. A faint trail runs north to south here.

>n
Denser Forest
The silent forest completely overwhelms everything. It is almost completely dark. The trail heads south back to your car or east deeper into the forest.

You can see a pile of leaves here.

>x leaves
You find that the pile of leaves only contains leaves.

>count leaves
There are 69,105 leaves here.

>LOOK
Denser Forest
The silent forest completely overwhelms everything. It is almost completely dark. The trail heads south back to your car or east deeper into the forest.

You can see a pile of leaves here.

>LOOK
Denser Forest
The silent forest completely overwhelms everything. It is almost completely dark. The trail heads south back to your car or east deeper into the forest.

You can see a pile of leaves here.

>xyzzy
I'm not quite sure what you meant by that.

>e
Even Still Denser Forest
The forest is incredibly dense here. All is dark and still. You can barely see the trail. West leads back towards your car. The trail leads southeast to a faint glimmer of light.

>se
House Ruins
You are in a small clearing next to the ruins of a long collapsed house. Large boards, bits of white painted siding and the foundation are all that remain. A faint trail leads to the northwest.

You can see a beat up old mailbox (empty) here.

>x mailbox
A dented and rusty mailbox. The door has been torn off.

* * *

>LOOK
Side of the Road
You at the end of a little used dirt road. A dense, dark forest surrounds you. A narrow rocky trail leads to the north. It may have been a driveway at one time, but is too overgrown to tell for sure. To road leads back to Skunk Hollow to the southeast.

You can see your 1974 Ford Pinto (empty) here.

foo

>smell car
Ah, the sweet, sweet bouquet of burnt oil and neglect.

>listen to car
You have gotten used to the rather unpleasant clunking sounds from this car. Right now it is making the only sound in the forest; a gentle hissing.

* * *

>LOOK
Side of the Road
You at the end of a little used dirt road. A dense, dark forest surrounds you. A narrow rocky trail leads to the north. It may have been a driveway at one time, but is too overgrown to tell for sure. To road leads back to Skunk Hollow to the southeast.

You can see your 1974 Ford Pinto (empty) here.

foo

>eat forest
You eat some random berries. You die.

    *** That wasn't a good idea. ***

You scored 0 out of a possible 0, in 2 turns.

Would you like to RESTART, RESTORE a saved game, QUIT or UNDO the last command?

>undo
Side of the Road
[Previous turn undone.]

* * *

>LOOK
Side of the Road
You at the end of a little used dirt road. A dense, dark forest surrounds you. A narrow rocky trail leads to the north. It may have been a driveway at one time, but is too overgrown to tell for sure. To road leads back to Skunk Hollow to the southeast.

You can see your 1974 Ford Pinto (empty) here.

foo

>n
Dense Forest
You are in a dense forest. Only occasionally can the sky be seen through the canopy. A faint trail runs north to south here.

foo

>n
Denser Forest
The silent forest completely overwhelms everything. It is almost completely dark. The trail heads south back to your car or east deeper into the forest.

You can see a pile of leaves here.

>e
Even Still Denser Forest
The forest is incredibly dense here. All is dark and still. You can barely see the trail. West leads back towards your car. The trail leads southeast to a faint glimmer of light.

>w
Denser Forest
The silent forest completely overwhelms everything. It is almost completely dark. The trail heads south back to your car or east deeper into the forest. A faint animal path leads northwest.

You can see a pile of leaves here.

>nw
Faint animal path
A faint animal path runs northwest to southeast.

>LOOK
Faint animal path
A faint animal path runs northwest to southeast.

>se
Denser Forest
The silent forest completely overwhelms everything. It is almost completely dark. The trail heads south back to your car or east deeper into the forest. A faint animal path leads northwest.

You can see a pile of leaves here.

>move leaves
You push the pile of leaves.

* * *

>move leaves
When you move the leaves, you notice some animal tracks going to the northwest.

>l
Denser Forest
The silent forest completely overwhelms everything. It is almost completely dark. The trail heads south back to your car or east deeper into the forest. A faint animal path leads northwest.

You can see a pile of leaves here.

>nw
Faint animal path
A faint animal path runs northwest to southeast.

>nw
You can't go that way.

[In fact, you can't see any obvious exits.]

>se
You can't go that way.

[In fact, you can't see any obvious exits.]

* * *

>d
Darkness
It is pitch black. You are likely to be eaten by a grue.

>d
Foo
Darkness
It is pitch black. You are likely to be eaten by a grue.

>d
Foo
It is pitch dark, and you can't see a thing.

>s
Darkness
It is pitch dark, and you can't see a thing.

>l
Darkness
It is pitch dark, and you can't see a thing.

>u
It is pitch dark, and you can't see a thing.

>w
It is pitch dark, and you can't see a thing.

>e
It is pitch dark, and you can't see a thing.

>s
It is pitch dark, and you can't see a thing.

* * *

>d
Foo
It is pitch dark, and you can't see a thing.

>u
Foo
Darkness
It is pitch black. You are likely to be eaten by a grue.

>d
Foo
Darkness
It is pitch black. You are likely to be eaten by a grue.

>u
Foo
Darkness
It is pitch black. You are likely to be eaten by a grue.

>D
Foo
Darkness
It is pitch black. You are likely to be eaten by a grue.

>e
Foo
It is pitch dark, and you can't see a thing.

>w
Foo
It is pitch dark, and you can't see a thing.

>ew
[That's not a verb I recognise.]

>e
Foo
It is pitch dark, and you can't see a thing.

>e
Foo
It is pitch dark, and you can't see a thing.

>l
Darkness
It is pitch black. You are likely to be eaten by a grue.

>u
FooBar
Darkness
It is pitch black. You are likely to be eaten by a grue.

>d
FooBar
Darkness
It is pitch black. You are likely to be eaten by a grue.

>u
FooBarOh no! You have walked into the slavering fangs of a lurking grue!

    *** You are tasty. ***

You scored 0 out of a possible 0, in 26 turns.

Would you like to RESTART, RESTORE a saved game, QUIT or UNDO the last command?

* * *

>d
Darkness
It is pitch black. You are likely to be eaten by a grue.

>l
Darkness
It is pitch black. You are likely to be eaten by a grue.

>m
[That's not a verb I recognise.]

>i
You are carrying:
  a map
  a flashlight
  a backpack (being worn and closed)

>d
Foo
Darkness
It is pitch black. You are likely to be eaten by a grue.

>turn on flashlight
You push the button on the flashlight. Nothing happens. You realized that you forgot to check the batteries before heading out. The flashlight is not going to be of much use today. Oh well, at least you can still look around on the surface.

>g
You push the button on the flashlight. Nothing happens.

>d
It is pitch dark, and you can't see a thing.

>u
Darkness
It is pitch dark, and you can't see a thing.

>w
It is pitch dark, and you can't see a thing.

>u
Clearing
A small clearing in the forest. The most notable aspect is a largish rabbit hole off to the side

* * *

>d
Foo
Darkness
It is pitch black. You are likely to be eaten by a grue.

>LOOK
Darkness
It is pitch black. You are likely to be eaten by a grue.

>e
It is pitch dark, and you can't see a thing.

>d
It is pitch dark, and you can't see a thing.

>w
It is pitch dark, and you can't see a thing.

>s
Darkness
It is pitch black. You are likely to be eaten by a grue.

>e
It is pitch dark, and you can't see a thing.

>e
It is pitch dark, and you can't see a thing.

>w
It is pitch dark, and you can't see a thing.

>n
Darkness
It is pitch black. You are likely to be eaten by a grue.

>u
Darkness
It is pitch black. You are likely to be eaten by a grue.

* * *

>LOOK
Darkness
It is pitch black. You are likely to be eaten by a grue.

>w
It is pitch dark, and you can't see a thing.

>d
It is pitch dark, and you can't see a thing.

>u
Darkness
It is pitch black. You are likely to be eaten by a grue.

>eat
[What do you want to eat?]

>food
You can't see any such thing.

>i
You are carrying:
  a map
  a flashlight
  a backpack (being worn and closed)

>jump
[Jumping would have no effect, or that's not the way to do so.]

>e
It is pitch dark, and you can't see a thing.

* * *

>w
It is pitch dark, and you can't see a thing.

>LOOK
Darkness
It is pitch black. You are likely to be eaten by a grue.

>x map
FooIt is pitch dark, and you can't see a thing.

* * *

>LOOK
Darkness
It is pitch black. You are likely to be eaten by a grue.

>LOOK
Darkness
It is pitch black. You are likely to be eaten by a grue.

* * *

>d
It is pitch dark, and you can't see a thing.

>d
It is pitch dark, and you can't see a thing.

* * *

>w
It is pitch dark, and you can't see a thing.

>u
Darkness
It is pitch black. You are likely to be eaten by a grue.

>e
It is pitch dark, and you can't see a thing.

* * *

>s
It is pitch dark, and you can't see a thing.

>d
Darkness
It is pitch black. You are likely to be eaten by a grue.

* * *

>u
Darkness
It is pitch black. You are likely to be eaten by a grue.

>d
Darkness
It is pitch black. You are likely to be eaten by a grue.

>y
[Saying yes here has no effect.]

>u
Darkness
It is pitch black. You are likely to be eaten by a grue.

* * *

>LOOK
Darkness
It is pitch black. You are likely to be eaten by a grue.

>d
FooOh no! You have walked into the slavering fangs of a lurking grue!

    *** You are tasty. ***

You scored 0 out of a possible 0, in 12 turns.

Would you like to RESTART, RESTORE a saved game, QUIT or UNDO the last command?

>u
Darkness
It is pitch black. You are likely to be eaten by a grue.

* * *

>d
Darkness
It is pitch black. You are likely to be eaten by a grue.

>d
It is pitch dark, and you can't see a thing.

* * *

>w
It is pitch dark, and you can't see a thing.

>s
It is pitch dark, and you can't see a thing.

>e
It is pitch dark, and you can't see a thing.

* * *

>d
FooOh no! You have walked into the slavering fangs of a lurking grue!

    *** You are tasty. ***

You scored 0 out of a possible 0, in 12 turns.

Would you like to RESTART, RESTORE a saved game, QUIT or UNDO the last command?

[Please give one of the answers above.]

Would you like to RESTART, RESTORE a saved game, QUIT or UNDO the last command?

>undo
Darkness
[Previous turn undone.]

>u
FooOh no! You have walked into the slavering fangs of a lurking grue!

    *** You are tasty. ***

You scored 0 out of a possible 0, in 12 turns.

Would you like to RESTART, RESTORE a saved game, QUIT or UNDO the last command?

* * *

>i
You are carrying:
  a map
  a flashlight
  a backpack (being worn and closed)

>LOOK
Darkness
It is pitch black. You are likely to be eaten by a grue.

>u
Foo
Clearing
A small clearing in the forest. The most notable aspect is a largish rabbit hole off to the side

>d
Darkness
It is pitch black. You are likely to be eaten by a grue.

* * *

>LOOK
Darkness
It is pitch black. You are likely to be eaten by a grue.

>d
Foo
Darkness
It is pitch black. You are likely to be eaten by a grue.

* * *

>d
Foo
It is pitch dark, and you can't see a thing.

>u
FooOh no! You have walked into the slavering fangs of a lurking grue!

    *** You are tasty. ***

You scored 0 out of a possible 0, in 13 turns.

Would you like to RESTART, RESTORE a saved game, QUIT or UNDO the last command?

>undo
Darkness
[Previous turn undone.]

* * *

>d
Foo
It is pitch dark, and you can't see a thing.

>d
Foo
It is pitch dark, and you can't see a thing.

>w
Foo
It is pitch dark, and you can't see a thing.

>e
Foo
It is pitch dark, and you can't see a thing.

>u
Foo
Darkness
It is pitch black. You are likely to be eaten by a grue.

* * *

>d
Foo
Darkness
It is pitch black. You are likely to be eaten by a grue.

>e
Foo
It is pitch dark, and you can't see a thing.

* * *

>l
Darkness
It is pitch black. You are likely to be eaten by a grue.

>d
Darkness
It is pitch black. You are likely to be eaten by a grue.

* * *

>d
It is pitch dark, and you can't see a thing.

>e
It is pitch dark, and you can't see a thing.

* * *

>u
Clearing
A small clearing in the forest. The most notable aspect is a largish rabbit hole off to the side

>se
Faint animal path
A faint animal path runs northwest to southeast.

>se
Denser Forest
The silent forest completely overwhelms everything. It is almost completely dark. The trail heads south back to your car or east deeper into the forest. A faint animal path leads northwest.

You can see a pile of leaves here.

>e
Even Still Denser Forest
The forest is incredibly dense here. All is dark and still. You can barely see the trail. West leads back towards your car. The trail leads southeast to a faint glimmer of light.

* * *

>se
House Ruins
You are in a small clearing next to the ruins of a long collapsed house. Large boards, bits of white painted siding and the foundation are all that remain. A faint trail leads to the northwest.

You can see a beat up old mailbox (empty) here.

>take mailbox
Taken.

>n
You can't go that way.

[From here, you can go northwest and south.]

* * *

>s
Amidst the Ruins
You are just inside of the ruins. It looks like most of the house has fallen into its own cellar.

>search
(Amidst the Ruins)
Amidst the Ruins
You are just inside of the ruins. It looks like most of the house has fallen into its own cellar.

>search debris
You paw around in the mounds of debris and uncover an unexpectedly undamaged brass lantern

>take it
[That is just scenery, and can't be taken.]

>take lantern
(putting the flashlight into the backpack to make room)
Taken.

>search debris
You paw around some more in the ruins. Underneath a large timber, you see a debris filled stairway going down. Unfortunately, it is completely blocked.

>g
You paw around in the mounds of debris and uncover an unexpectedly undamaged brass lantern

>g
You paw around in the mounds of debris and uncover an unexpectedly undamaged brass lantern

>i
You are carrying:
  a beat up old mailbox
  a map
  a backpack (being worn and open)
    a flashlight

>take lantern
Taken.

>i
You are carrying:
  a brass lantern
  a beat up old mailbox
  a map
  a backpack (being worn and open)
    a flashlight

>n
House Ruins
You are in a small clearing next to the ruins of a long collapsed house. Large boards, bits of white painted siding and the foundation are all that remain. A faint trail leads to the northwest.

>nw
Even Still Denser Forest
The forest is incredibly dense here. All is dark and still. You can barely see the trail. West leads back towards your car. The trail leads southeast to a faint glimmer of light.

>w
Denser Forest
The silent forest completely overwhelms everything. It is almost completely dark. The trail heads south back to your car or east deeper into the forest. A faint animal path leads northwest.

You can see a pile of leaves here.

* * *

>d
Darkness
It is pitch black. You are likely to be eaten by a grue.

>turn on lantern
You turn on the brass lantern.

rabbit warren
A cramped earthen room. It looks like a small passage descends to the southwest.

>d
Bottom of Rabbit Hole

>LOOK
Bottom of Rabbit Hole

>se
You can't go that way.

[From here, you can go south and up.]

>s
Low Passage

>LOOK
Low Passage

>d
Muddy Passage
You are quite deep underground now. A tall muddy passage. The floor is wet. There is glowing something growing on the walls and ceiling of this damp place that provides just enough light to see by.

>ne
Small room

>e
Narrow Passage

>x bloodstains
You can't see any such thing.

>LOOK
Narrow Passage

>sw
unstable room
You can see a note and a frayed rope here.

>x bloodstains
You can't see any such thing.

>LOOK
unstable room
You can see a note and a frayed rope here.

>actions
Actions listing on.

>objects
[That's not a verb I recognise.]

>object
[That's not a verb I recognise.]

>l
[looking]
unstable room
You can see a note and a frayed rope here.

[looking - succeeded]

>LOOK
[looking]
unstable room
You can see a note and a frayed rope here.

[looking - succeeded]

>s
[going south]

turnip room
You can see a very angry turnip here.

[going south - succeeded]

>showobj room
[That's not a verb I recognise.]

>showobj
[That's not a verb I recognise.]

>tree
compass (5)
  the north
  the northeast
  the northwest
  the south
  the southeast
  the southwest
  the east
  the west
  the up
  the down
  the inside
  the outside
(LibraryMessages) (6)
(darkness object) (7)
(Inform Parser) (8)
(Inform Library) (9)
(property_numberspace_forcer) (10)
(ValuePropertyHolder_39) (12)
Bloodstains (48)
creepy forest (49)
Dark forest (50)
Side of the Road (51)
  your 1974 Ford Pinto
Dense Forest (53)
Denser Forest (54)
  a pile of leaves
Even Still Denser Forest (56)
House Ruins (57)
Amidst the Ruins (59)
  Rubble filled stairway
  Rubble
limbo (61)
  gnome porn
  a Wumpus
Faint animal path (66)
Clearing (67)
Underground (68)
rabbit warren (69)
Bottom of Rabbit Hole (70)
Low Passage (71)
Muddy Passage (72)
Small room (73)
Narrow Passage (74)
Interesting Room (75)
  a sign
unstable room (77)
  a note
  a frayed rope
Dead Letter Office (80)
turnip room (81)
  xyzzy
  yourself
    a brass lantern (providing light)
    a beat up old mailbox
    a map
    a backpack (being worn and open)
      a flashlight
  a very angry turnip

* * *

>d
Muddy Passage
You are quite deep underground now. A tall muddy passage. The floor is wet. There is glowing something growing on the walls and ceiling of this damp place that provides just enough light to see by.

>LOOK
Muddy Passage
A tall muddy passage. The floor is wet. There is glowing something growing on the walls and ceiling of this damp place that provides just enough light to see by.

>e
You can't go that way.

[From here, you can go northeast and up.]

>ne
Small room

>LOOK
Small room

>e
Narrow Passage

>l
Narrow Passage

>x bloodstains
bloodstains

>sw
unstable room
You can see a note and a frayed rope here.

>x bloodstains
bloodstains

>se
You can't go that way.

[From here, you can go northeast and south.]

>s
turnip room
You can see a very angry turnip here.

>LOOK
turnip room
You can see a very angry turnip here.

>x bloodstains
[You can't see Bloodstains any more.]

>n
unstable room
You can see a note and a frayed rope here.

>x bloodstains
bloodstains

>LOOK
unstable room
You can see a note and a frayed rope here.

>ne
Narrow Passage

>x wumpus
You can't see any such thing.

>x bloodstains
bloodstains

>u
You can't go that way.

[From here, you can go northwest, south, southwest and west.]

>s
Interesting Room
You can see a Wumpus and a sign here.

>x wumpus
You see nothing unexpected about the Wumpus.

>n
Narrow Passage

* * *

>nw
Clearing
A small clearing in the forest. The most notable aspect is a largish rabbit hole off to the side

>LOOK
Clearing
A small clearing in the forest. The most notable aspect is a largish rabbit hole off to the side

>d
Darkness
It is pitch black. You are likely to be eaten by a grue.

* * *

>w
It is pitch dark, and you can't see a thing.

>w
It is pitch dark, and you can't see a thing.

* * *

>LOOK
Darkness
It is pitch black. You are likely to be eaten by a grue.

>i
You are carrying:
  a map
  a flashlight
  a backpack (being worn and closed)

>e
It is pitch dark, and you can't see a thing.

>turn on flashlight
You push the button on the flashlight. Nothing happens. You realized that you forgot to check the batteries before heading out. The flashlight is not going to be of much use today. Oh well, at least you can still look around on the surface.

>e
It is pitch dark, and you can't see a thing.

* * *

>n
Dense Forest
You are in a dense forest. Only occasionally can the sky be seen through the canopy. A faint trail runs north to south here.

foo

>e
You can't go that way.

[From here, you can go north and south.]

>n
Denser Forest
The silent forest completely overwhelms everything. It is almost completely dark. The trail heads south back to your car or east deeper into the forest.

You can see a pile of leaves here.

foo

>LOOK
Denser Forest
The silent forest completely overwhelms everything. It is almost completely dark. The trail heads south back to your car or east deeper into the forest.

You can see a pile of leaves here.

foo

* * *

>eat your car
>EAT YOURSELF CAR
[I only understood the first part of that-- trying anyway.]
>EAT YOURSELF
[You can't eat yourself.]

>eat car
(first taking your 1974 Ford Pinto)
[Your 1974 Ford Pinto isn't portable.]

* * *

>eat car
The tires are chewy.

(first taking your 1974 Ford Pinto)
[Your 1974 Ford Pinto isn't portable.]

* * *

>eat the car
The tires are chewy.

>drink the car
You could drink the gas or oil, but that stuff is too expensive.

>take car
[Your 1974 Ford Pinto isn't portable.]

>search car
Your 1974 Ford Pinto is empty.

>x it
Unreliable, rusty, and likely to explode.

* * *

>taste car
You taste nothing unexpected.

* * *

>x forest
A dark, incredibly dense forest surrounds you.

* * *

>listen to forest
You only hear a gentle hissing and clunking coming from your car.

>n
Dense Forest
You are in a dense forest. Only occasionally can the sky be seen through the canopy. A faint trail runs north to south here.

>listen to forest
It is absolutely quiet.

>eat it
(first taking Dark forest)
[That is just scenery, and can't be taken.]

* * *

>; 1*2*3*4*5*6*7
>; 1 2 3 4 5 6 7
>. 1 2 3 4 5 6 7
[You typed a rather long command and I didn't understand it. It's better to stick to simpler things like TAKE FLASHLIGHT.]

>LOOK
Side of the Road
You at the end of a little used dirt road. A dense, dark forest surrounds you. A narrow rocky trail leads to the north. It may have been a driveway at one time, but is too overgrown to tell for sure. To road leads back to Skunk Hollow to the southeast.

You can see your 1974 Ford Pinto (empty) here.

>showverb look
Verb 'l' 'look' 'see'
     * -> Look
     * 'around' / 'about' -> Look
     * noun=Routine(27207) -> A84_overly_elaborate_looking
     * noun -> Examine
     * 'at' / 'around' / 'in' / 'into' noun=Routine(27204) -> A84_overly_elaborate_looking
     * 'at' noun -> Examine
     * 'inside' / 'in' / 'into' / 'through' noun -> Search
     * 'under' noun -> LookUnder
     * 'at' / 'for' scope=Routine(27210) -> A87_remembering
     * 'at' / 'around' / 'in' / 'into' 'the' / 'a' / 'an' / 'some' noun=Routine(27201) -> A84_overly_elaborate_looking
     * 'up' topic 'in' noun -> Consult reverse

>tree
compass (5)
  the north
  the northeast
  the northwest
  the south
  the southeast
  the southwest
  the east
  the west
  the up
  the down
  the inside
  the outside
(LibraryMessages) (6)
(darkness object) (7)
(Inform Parser) (8)
(Inform Library) (9)
(property_numberspace_forcer) (10)
(ValuePropertyHolder_39) (12)
Bloodstains (48)
creepy forest (49)
Side of the Road (51)
  Dark forest
  xyzzy
  yourself
    a map
    a flashlight
    a backpack (being worn and closed)
  your 1974 Ford Pinto
Dense Forest (53)
Denser Forest (54)
  a pile of leaves
Even Still Denser Forest (56)
House Ruins (57)
  a beat up old mailbox
Amidst the Ruins (59)
  Rubble
limbo (61)
  a brass lantern
  gnome porn
Rubble filled stairway (65)
Faint animal path (66)
Clearing (67)
Underground (68)
rabbit warren (69)
Bottom of Rabbit Hole (70)
Low Passage (71)
Muddy Passage (72)
Small room (73)
Narrow Passage (74)
Interesting Room (75)
  a sign
unstable room (77)
  a note
  a frayed rope
Dead Letter Office (80)
turnip room (81)
  a Wumpus
  a very angry turnip

>show wumpus
You can't see any such thing.

* * *

>tree
compass (5)
  the north
  the northeast
  the northwest
  the south
  the southeast
  the southwest
  the east
  the west
  the up
  the down
  the inside
  the outside
(LibraryMessages) (6)
(darkness object) (7)
(Inform Parser) (8)
(Inform Library) (9)
(property_numberspace_forcer) (10)
(ValuePropertyHolder_39) (12)
Bloodstains (48)
creepy forest (49)
Side of the Road (51)
  Dark forest
  xyzzy
  yourself
    a map
    a flashlight
    a backpack (being worn and closed)
  your 1974 Ford Pinto
Dense Forest (53)
Denser Forest (54)
  a pile of leaves
Even Still Denser Forest (56)
House Ruins (57)
  a beat up old mailbox
Amidst the Ruins (59)
  Rubble
limbo (61)
  a brass lantern
  gnome porn
Rubble filled stairway (65)
Faint animal path (66)
Clearing (67)
Underground (68)
rabbit warren (69)
Bottom of Rabbit Hole (70)
Low Passage (71)
Muddy Passage (72)
Small room (73)
Narrow Passage (74)
Interesting Room (75)
  a sign
unstable room (77)
  a note
  a frayed rope
Dead Letter Office (80)
turnip room (81)
  a Wumpus
  a very angry turnip